Яблоко от яблони	недалеко падает
Пришла беда —	отворяй ворота
Что в лоб, что	по лбу
Как корова	языком слизнула
Чем богаты,	тем и рады
Не рой яму другому —	сам в нее попадешь
Волос долог,	да ум короток
Умный бы ты был человек —	кабы не дурак
Кому война, а	кому мать родна
Без царя	в голове
Смелому и 	море по колено
Укатали сивку	крутые горки
На воре и	шапка горит
У страха	глаза велики
Хвост вытащишь —	голова увязнет
Тише едешь — 	дальше будешь
Хорошо там,	где нас нет
Гусь свинье	не товарищ
Сядем рядком да	потолкуем ладком
Не в бровь, а 	в глаз
Слово — серебро, а молчание —	 золото
Семь пятниц	на неделе
Копейка рубль	бережет
Седина в бороду — 	бес в ребро
Из огня да	в полымя
Сделал дело — 	гуляй смело
Не хошь кулеш —	ничего не ешь
Сам заварил кашу —	сам её и расхлебывай
С волками жить —	по волчьи выть
Русский медленно запрягает, да	быстро едет
Щи да каша — 	пища наша
Раз на раз	не приходится
Шила в мешке	не утаишь
Что упало, 	то пропало
Переливать из пустого	в порожнее
Первый блин —	комом
Уродится не уродится, а	
Паршивая овца	все стадо портит
Один в поле	не воин
У семи нянек	дитя без глазу
Овчинка выделки	не стоит
Терпенье и труд	все перетрут
Обещать — дело господское, 	исполнять — холопское
Такое сено, что сам бы ел, да	деньги нужны
Быстро только	кошки родятся
Сытое брюхо	к учению глухо
Старый друг лучше	новых двух
Новая метла	по-новую метет
Сосед спать не дает:	хорошо живет
Ни уму, 	ни сердцу
Собака лает —	ветер носит
Ни богу свечка, 	ни черту кочерга
Слово — не воробей,	вылетит — не воротишь
Нет дыма	без огня
Семь раз отмерь —	один раз отрежь
Своя рубашка	ближе к телу
Не так страшен черт,	как его малюют
С поганой овцы —	хоть шерсти клок
С глаз долой —  	из сердца вон
Не плюй в колодец — 	придется напиться
Рыба рыбою сыта, а	человек человеком
Нечего на зеркало пенять, коли	рожа крива
Рука руку моет, 	вор вора кроет
Не обманешь —	не продашь
Речист, да	на руку не чист
Не мытьем, так	
Работа не вол —	в лес не убежит
Не знаешь, где найдешь,	где потеряешь
Не буди лихо, пока	 оно тихо
Пьяному море по колено,  а	лужа по уши
Нашла коса 	на камень
Пуганая ворона и 	 куста боится
Назвался груздем	полезай в кузов
Пришел марток, 	надевай двое порток
На нет и	суда нет
На нас где сядешь, 	там и слезешь
Поспешишь — 	людей насмешишь
На каждый роток	не накинешь платок
Посеешь поступок, 	пожнёшь привычку
На каждый чих 	не наздравствуешься
Попытка — не пытка, а	 спрос — не беда
На Бога надейся, а 	сам не плошай
Пока не запряг 	не нукай
Мягко стелет, да 	жёстко спать
Поели, попили, пора	 и честь знать
Мы люди не гордые:	нету хлеба, давай пироги
По Сеньке и	
Муж да жена — 	одна сатана
Муж — голова, а 	жена — шея
Плохо овцам, коли 	волк пастух
Моя хата с краю, 	никого не знаю
Охал бы ты дядя 	на себя глядя
Маленькая собачка 	всю жизнь щенок
Два сына — полсына, 	три сына — сын
Мал клоп, да 	
Любишь кататься — 	люби и саночки возить
Нос вытащил — хвост увяз, хвост вытащил — 	нос увяз
Лучше синица в руках, чем 	журавль в небе
Ни два ни 	полтора
Лучше поздно, чем 	никогда
Нет худа без 	никогда
Как пришло, так и 	ушло
Нет друга, так ищи, а нашёл, так 	береги
Ласковый теленок 	двух маток сосёт
Не тот вор, что крадёт, а тот вор, что 	концы хоронит
Куй железо, пока 	горячо
Не строй церкви, 	пристрой сироту
Со свиным-то рылом, да 	в калашный ряд
Не по достатку еда —	 тоже беда
Куда ни кинь — 	всё клин
Не откладывай на завтра то, что	 можешь сделать сегодня
Кто рано встаёт, тому	 Бог даёт
Не окрикнув лошади, 	в стойло не лезь
Что посеешь, то и 	пожнешь
Сытого потчевать 	не накладно
Кто не успел, тот 	опоздал
Не любо — не слушай, а 	врать не мешай
133 Кто много знает, тот мало верит	
Не красна изба углами — 	красна пирогами
Кто про что, а 	вшивый про баню
Не за то волка бьют, что сер, а за то, что 	овцу съел
Кто в лес, кто 	по дрова
Не душой худ, а 	просто плут
Не всё то золото, что 	блестит
Конь о четырёх ногах, а 	спотыкается
Наше дело телячье — 	поел да в закут
Наш пострел 	везде поспел
На чужой медок — 	не разевай роток
На золоте стоим, а 	нагнуться ленимся
На других умён, 	на себя глуп
На всех угождать — 	самому в дураках сидеть
Как потопаешь, 	так и полопаешь
Много нам бед делали — 	хан крымский да папа римский
Как аукнется, так и 	откликнется
Много выбирать — 	женатым не бывать
К чему душа лежит, к тому 	и руки приложатся
Милые бранятся — 	только тешатся
Из грязи да 	в князи
Люди пахать, а 	мы руками махать
И швец, и жнец, и 	на дуде игрец
Любишь гостить — 	люби и к себе звать
Любишь гостить —	люби и к себе звать
Знать не знаю,	ведать не ведаю
Кот из дому,	мыши в пляс
Незваный гость —	хуже татарина
Коготок увяз —	всей птичке пропасть
Запасливый лучше	богатого
Каков вопрос, таков и	ответ
Где боком, где	скоком
За всё браться —	ничего не сделать
За спрос и показ	денег не берут
Жид	обманом сыт
За морем телушка — полушка,	да рупь — перевоз
Жена ублажает —	лихое замышляет
Жаль, жаль, а	пособить нечем
Жизнь прожить —	не поле перейти
Жалует царь,	да не жалует псарь
Хитрость лисы —	в глупости куриц
Есть терпение —	будет и умение
Ври да 	не завирайся!
Его пустили погреться, а	он уж и детей крестить
Жена не лапоть:	с ноги не сбросишь
Дружба дружбой, а	служба службой
Желай по силам,	тянись по достатку
Дочернины дети	милее своих
Если бы да кабы,	да во рту росли грибы
Добрый портной	с запасом шьёт
Хоть кол на голове теши —	он все своё
Добро должно быть	с кулаками
Ты ему слово —	он тебе десять
До свадьбы	заживёт
И смех,	и грех
До Бога высоко,	до царя далеко
Выдрали как	Сидорову козу
Дитя не плачет —	мать не разумеет
Вчера не догонишь, а	от завтра не уйдёшь
Деньги не голова:	дело наживное
Всяк кулик	своё болото хвалит
Девичье «нет» —	не отказ
Всяк сверчок	знай свой шесток
Давай дружить: то я к тебе, то	 ты меня к себе
Всему своё	время
Голодный волк сильнее	сытой собаки
Где родился —	там и пригодился
Голова как лукошко, а	ума ни крошки
Все мы под Богом	ходим
Говорить правду —	терять дружбу
Старый конь борозды не портит, но и	глубоко не пашет
Где клятва, тут и	преступление
Ворон ворону	глаз не выклюет
Всякая козявка	лезет в букашки
Вор у вора	дубинку украл
Все черти	одной шерсти
Волка	ноги кормят
Вместе тошно, а	врозь скучно
Вода	камень точит
Вечный мир —	до первой драки
Слово — серебро, молчанье —	золото
В людях лапочка, а	дома чёрт
Птицу видно	по полету
В деньгах	родства нет
Видит око, да	зуб неймёт
В весёлый час и	смерть не страшна
Взялся за гуж —	не говори, что не дюж
Баба и	чёрта перехитрит
Велика фигура —	да дура
Барин за барина, мужик —	за мужика
Мал золотник —	да дорог
Бедному зятю и	тесть не рад
Век живи — век учись, а	дураком помрешь
Бедному	смерть не страшна
Ваши бы слова да	Богу в уши
Бела берёза, да	дёготь чёрен
Вали валом –	потом разберем
Белую ворону и	свои заклюют
В чужой монастырь	со своим уставом не ходят
Блудлив как кот,	труслив как заяц
Бери в работе умом, а	не горбом
Блудный сын —	ранняя могила отцу
Беспутному сыну и	богатство не впрок
В тихом омуте	черти водятся
В гостях хорошо, а	дома лучше
Богатый как хочет, а	бедный как может
Один с сошкой, а	семеро с ложкой
Болтун речист, да	на руку не чист
Баба с возу — 	кобыле легче
Большому уму и	в маленькой голове не тесно
Борода до колена, а	дров ни полена
Беда не приходит	одна
Брюхо сыто, да	глаза голодны
Будет добро, да	долго ждать
Без труда 	не вытащить и рыбки из пруда
Будет тихо —	будет и лихо
Бей своих, чтобы	чужие боялись 
Богатого не отличишь от	вороватого
Будь малым доволен —	больше получишь
Береги платье снову, а 	честь смолоду
Был бы конь, а	уздечку найдём
Бережёного Бог	бережёт
Был в той школе — 	уж не обманешь
Дурная голова	ногам покоя не даёт
Дуракам закон	не писан
Дружба дружбой, а	табачок врозь
Ближний сосед лучше	дальней родни
Близок локоток, да	не укусишь
Друг	познаётся в беде
Дорога ложка	к обеду
Бог дал,	Бог и взял
Или пан,	или пропал
Бог не выдаст — 	свинья не съест
Долгие проводы —	лишние хлопоты
Бог не Тимошка,	видит немножко
Долг платежом	красен
Доверяй, но	проверяй
Деньги счёт	любят
Богатство — грязь, ум — 	золото
Делу время — 	потехе час
Богатство с деньгами	голь с весельем
Дело мастера	боится
Бодливой корове	Бог рог не даёт
Двое пашут, а	семеро руками машут
Божьем именем	сыт не будешь
Дают — бери, а бьют — 	беги
Боится, точно	чёрт ладана
Больше пота — 	меньше крови
Дарёному коню	в зубы не смотрят
Дай с ноготок,	запросит с локоток
Большому куску и	рот рад
Браниться бранись, а	за милого держись
Готовь сани летом, а	телегу зимой
Будет день — 	будет пища
Горбатого	могила исправит
Будешь много знать —	скоро состаришься
Будь как дома, но не забывай, что	в гостях
Говорят, что кур доят, а пошли, и	титек не нашли
Что у трезвого на уме, то	у пьяного на языке
Был конь, да	изъездился
Глаза боятся, а 	руки делают
Был ум — да	весь вышел
Смотрю в книгу —	вижу фигу
Была бы шея, а	хомут найдётся
В бане веник — 	дороже денег
Было, да	сплыло
Да он лыка не	вяжет